pwd - Проверка текущей директории.

ls (list) — программа, которая выводит список файлов и директорий в рабочей (текущей) директории.

cd (change directory), с помощью неё осуществляется перемещение по файловой структуре.

~ Домашняя директория пользователя

man - смотреть документацию соответствующей программы //https://explainshell.com//

stat - Информация о любом файле или директории.

cat - прочитать файл.

head и tail - посмотреть только начало файла или его конец. // head -n 10 первые десять строк файла.

less - Особая категория программ для просмотра содержимого файла — пейджеры.

grep (global regular expression print) - выполняющей поиск по файлу или файлам определённого текста.

vim .bashrc - текстовый редактор.

ПОТОКИ:

STDIN (Standard Input) - отвечает за вывод на экран.

STDOUT (Standard Output) - вывод на экран.// > и >> 

STDIN - стандартный ввод // <

STDERR - вывод ошибок. // 

ПРИМЕР ПАЙПЛАЙНА: 

cat source | grep Dog | uniq | sort
1. Читается файл source
2. Входные данные грепаются по подстроке "Dog"
3. Убираются дубли (в исходном файле две одинаковых строки "Dog")
4. Входные данные сортируются и выводятся на экран.

touch - команда для создания файла.

rm (remove files) - удалить файл
rm -r - удаление директории.
rm -rf - удаление директории без вопросов.

mv (move) - Переименование всегда равносильно перемещению, которое выполняется командой.

cp (copy) - Для копирования файлов и директорий. //Её первый аргумент — имя источника (откуда), второй — имя приёмника (куда).

mkdir - Создание директории. // -p создание вложенных директорий.

env - Посмотреть установленные переменные. //https://ru.hexlet.io/courses/cli-basics/lessons/environment-variables/theory_unit

history - Посмотреть историю команд. // history 5, то отобразятся только 5 последних введённых команд
При необходимости историю всегда можно погрепать:
history | grep export

whoami - позволяет выяснить, кто же я такой.

ps (process status) - выводит отчёт о работающих процессах.
ps aux - Информацию о том, какой процесс и под каким пользователем запущен.

id - Группы, ассоциированные с текущим пользователем.

sudo (substitute user and do — дословно "подменить пользователя и выполнить")

ПРАВА ДОСТУПА.
пример:
-rw-r--r-- 1 kirill.m kirill.m 3771 Aug 31  2015 .bashrc
rw- означает, что владелец этого файла может как читать (r) этот файл, так и писать (w) в него. Последний прочерк означает, что этот файл нельзя исполнять.
Запись r-- говорит о наличии доступа только для чтения, а изменение запрещено. То же самое касается и тех, кто не входит в эту группу, то есть набор прав у последних двух одинаковый.




